RANK,TITLE,WORLDWIDE_LIFETIME_GROSS,DOMESTIC_LIFETIME_GROSS,DOMESTIC_PERCENTAGE,FOREIGN_LIFETIME_GROSS,FOREIGN_PERCENTAGE,YEAR,MPAA
1,Avatar,2847379794,760507625,0.267,2086872169,0.733,2009,PG-13
2,Avengers: Endgame,2797501328,858373000,0.307,1939128328,0.693,2019,PG-13
3,Titanic,2201647264,659363944,0.3,1542283320,0.7,1997,PG-13
4,Star Wars: Episode VII - The Force Awakens,2069521700,936662225,0.45299999999999996,1132859475,0.547,2015,PG-13
5,Avengers: Infinity War,2048359754,678815482,0.331,1369544272,0.669,2018,PG-13
6,Spider-Man: No Way Home,1885056798,798056798,0.423,1087000000,0.5770000000000001,2021,PG-13
7,Jurassic World,1671537444,653406625,0.391,1018130819,0.609,2015,PG-13
8,The Lion King,1662899439,543638043,0.327,1119261396,0.6729999999999999,2019,G
9,The Avengers,1518815515,623357910,0.41,895457605,0.59,2012,PG-13
10,Furious 7,1515341399,353007020,0.233,1162334379,0.767,2015,PG-13
11,Frozen II,1450026933,477373578,0.32899999999999996,972653355,0.6709999999999999,2019,PG
12,Avengers: Age of Ultron,1402809540,459005868,0.327,943803672,0.6729999999999999,2015,PG-13
13,Black Panther,1347597973,700426566,0.52,647171407,0.48,2018,PG-13
14,Harry Potter and the Deathly Hallows: Part 2,1342359942,381447587,0.284,960912355,0.716,2011,PG-13
15,Star Wars: Episode VIII - The Last Jedi,1332698830,620181382,0.465,712517448,0.535,2017,PG-13
16,Jurassic World: Fallen Kingdom,1310466296,417719760,0.319,892746536,0.6809999999999999,2018,PG-13
17,Frozen,1281508100,400953009,0.313,880555091,0.687,2013,PG
18,Beauty and the Beast,1273576220,504481165,0.396,769095055,0.604,2017,PG
19,Incredibles 2,1243089244,608581744,0.49,634507500,0.51,2018,PG
20,The Fate of the Furious,1236005118,226008385,0.183,1009996733,0.8170000000000001,2017,PG-13
21,Iron Man 3,1214811252,409013994,0.337,805797258,0.6629999999999999,2013,PG-13
22,Minions,1159444662,336045770,0.29,823398892,0.71,2015,PG
23,Captain America: Civil War,1153337496,408084349,0.354,745253147,0.6459999999999999,2016,PG-13
24,Aquaman,1148528393,335104314,0.292,813424079,0.708,2018,PG-13
25,The Lord of the Rings: The Return of the King,1146436214,378251207,0.33,768185007,0.67,2003,PG-13
26,Spider-Man: Far from Home,1131927996,390532085,0.345,741395911,0.655,2019,PG-13
27,Captain Marvel,1128462972,426829839,0.37799999999999995,701633133,0.622,2019,PG-13
28,Transformers: Dark of the Moon,1123794079,352390543,0.314,771403536,0.6859999999999999,2011,PG-13
29,Skyfall,1108569499,304360277,0.275,804209222,0.725,2012,PG-13
30,Transformers: Age of Extinction,1104054072,245439076,0.222,858614996,0.778,2014,PG-13
31,Jurassic Park,1099428303,404214720,0.368,695213583,0.632,1993,PG-13
32,The Dark Knight Rises,1081153097,448149584,0.414,633003513,0.586,2012,PG-13
33,Joker,1074445730,335477657,0.312,738968073,0.688,2019,R
34,Star Wars: Episode IX - The Rise of Skywalker,1074149279,515202542,0.48,558946737,0.52,2019,PG-13
35,Toy Story 4,1073394593,434038008,0.40399999999999997,639356585,0.596,2019,G
36,Toy Story 3,1066970811,415004880,0.389,651965931,0.611,2010,
37,Pirates of the Caribbean: Dead Man's Chest,1066179747,423315812,0.397,642863935,0.603,2006,PG-13
38,The Lion King,1063611805,422783777,0.39799999999999996,640828028,0.602,1994,G
39,Rogue One: A Star Wars Story,1056057720,532177324,0.504,523880396,0.496,2016,PG-13
40,Aladdin,1050693953,355559216,0.33799999999999997,695134737,0.662,2019,PG
41,Pirates of the Caribbean: On Stranger Tides,1045713802,241071802,0.23,804642000,0.77,2011,PG-13
42,Despicable Me 3,1034800131,264624300,0.256,770175831,0.7440000000000001,2017,PG
43,Finding Dory,1028570942,486295561,0.473,542275381,0.527,2016,PG
44,Star Wars: Episode I - The Phantom Menace,1027082707,474544677,0.462,552538030,0.5379999999999999,1999,PG
45,Alice in Wonderland,1025468216,334191110,0.326,691277106,0.674,2010,PG
46,Zootopia,1024121104,341268248,0.33299999999999996,682852856,0.667,2016,PG
47,Harry Potter and the Sorcerer's Stone,1017713119,318886962,0.313,698826157,0.687,2001,PG
48,The Hobbit: An Unexpected Journey,1017030651,303030651,0.298,714000000,0.7020000000000001,2012,PG-13
49,The Dark Knight,1006102277,534987076,0.532,471115201,0.46799999999999997,2008,PG-13
50,Harry Potter and the Deathly Hallows: Part 1,977070383,296374621,0.303,680695762,0.6970000000000001,2010,PG-13
51,Despicable Me 2,970766005,368065385,0.379,602700620,0.621,2013,PG
52,The Jungle Book,966554929,364001123,0.377,602553806,0.623,2016,PG
53,Jumanji: Welcome to the Jungle,962542945,404540171,0.42,558002774,0.58,2017,PG-13
54,The Hobbit: The Battle of the Five Armies,962201338,255138261,0.265,707063077,0.735,2014,PG-13
55,Pirates of the Caribbean: At World's End,960996492,309420425,0.322,651576067,0.6779999999999999,2007,PG-13
56,The Hobbit: The Desolation of Smaug,959027992,258387334,0.26899999999999996,700640658,0.731,2013,PG-13
57,The Lord of the Rings: The Two Towers,947896241,342952511,0.36200000000000004,604943730,0.638,2002,PG-13
58,Harry Potter and the Order of the Phoenix,942201710,292382727,0.31,649818983,0.69,2007,PG-13
59,Finding Nemo,940352645,380843261,0.405,559509384,0.595,2003,
60,Harry Potter and the Half-Blood Prince,934483039,302334374,0.324,632148665,0.6759999999999999,2009,PG
61,Shrek 2,928760770,441226247,0.475,487534523,0.525,2004,PG
62,Bohemian Rhapsody,910809311,216668042,0.23800000000000002,694141269,0.762,2018,PG-13
63,The Battle at Lake Changjin,902540935,342411,0.001,902198524,1.0,2021,
64,The Lord of the Rings: The Fellowship of the Ring,898094742,316115420,0.35200000000000004,581979322,0.648,2001,PG-13
65,Harry Potter and the Goblet of Fire,896730264,290469928,0.324,606260336,0.6759999999999999,2005,PG-13
66,Spider-Man 3,894983373,336530303,0.376,558453070,0.624,2007,PG-13
67,Ice Age 3: Dawn of the Dinosaurs,886686817,196573705,0.222,690113112,0.778,2009,PG
68,Spectre,880681519,200074609,0.22699999999999998,680606910,0.773,2015,PG-13
69,Spider-Man: Homecoming,880166924,334201140,0.38,545965784,0.62,2017,PG-13
70,Harry Potter and the Chamber of Secrets,879793867,262641637,0.298,617152230,0.7020000000000001,2002,PG
71,Ice Age 4: Continental Drift,877244782,161321843,0.184,715922939,0.816,2012,PG
72,The Secret Life of Pets,875458631,368384330,0.42100000000000004,507074301,0.579,2016,PG
73,Batman v Superman: Dawn of Justice,873637528,330360194,0.37799999999999995,543277334,0.622,2016,PG-13
74,Wolf Warrior 2,870325439,2721100,0.003,867604339,0.997,2017,
75,Star Wars: Episode III - Revenge of the Sith,868390560,380270577,0.43799999999999994,488119983,0.562,2005,PG-13
76,The Hunger Games: Catching Fire,865011746,424668047,0.491,440343699,0.509,2013,PG-13
77,Guardians of the Galaxy Vol. 2,863756051,389813101,0.451,473942950,0.5489999999999999,2017,PG-13
78,Inside Out,858848019,356921711,0.41600000000000004,501926308,0.584,2015,PG
79,Venom,856085151,213515506,0.249,642569645,0.7509999999999999,2018,PG-13
80,Thor: Ragnarok,853983911,315058289,0.369,538925622,0.631,2017,PG-13
81,Inception,836848102,292587330,0.35,544260772,0.65,2010,PG-13
82,Transformers: Revenge of the Fallen,836303693,402111870,0.48100000000000004,434191823,0.519,2009,PG-13
83,The Twilight Saga: Breaking Dawn - Part 2,829747654,292324737,0.35200000000000004,537422917,0.648,2012,PG-13
84,Spider-Man,825025036,407022860,0.493,418002176,0.507,2002,PG-13
85,Wonder Woman,822854286,412845172,0.502,410009114,0.498,2017,PG-13
86,"Hi, Mom",822009764,,,822009764,1.0,2021,
87,Independence Day,817400891,306169268,0.375,511231623,0.625,1996,PG-13
88,Fantastic Beasts and Where to Find Them,814044001,234037575,0.28800000000000003,580006426,0.7120000000000001,2016,PG-13
89,Shrek the Third,813367380,322719944,0.397,490647436,0.603,2007,PG
90,Coco,807817888,210460015,0.26,597357873,0.74,2017,PG
91,Jumanji: The Next Level,800059707,320314960,0.4,479744747,0.6,2019,PG-13
92,Harry Potter and the Prisoner of Azkaban,797491273,250105651,0.314,547385622,0.6859999999999999,2004,PG
93,Pirates of the Caribbean: Dead Men Tell No Tales,794881442,172558876,0.217,622322566,0.7829999999999999,2017,PG-13
94,E.T. the Extra-Terrestrial,792910554,435110554,0.5489999999999999,357800000,0.451,1982,PG
95,Mission: Impossible - Fallout,791657398,220159104,0.278,571498294,0.722,2018,PG-13
96,2012,791217826,166112167,0.21,625105659,0.79,2009,PG-13
97,Indiana Jones and the Kingdom of the Crystal Skull,790653942,317101119,0.401,473552823,0.599,2008,PG-13
98,Spider-Man 2,788976453,373585825,0.474,415390628,0.526,2004,PG-13
99,Fast & Furious 6,788680968,238679850,0.303,550001118,0.6970000000000001,2013,PG-13
100,Deadpool 2,785896609,324591735,0.413,461304874,0.5870000000000001,2018,R
101,Deadpool,782836791,363070709,0.46399999999999997,419766082,0.536,2016,R
102,Star Wars,775398007,460998507,0.594,314399500,0.406,1977,PG
103,No Time to Die,774153007,160891007,0.20800000000000002,613262000,0.792,2021,PG-13
104,Guardians of the Galaxy,773350147,333718600,0.43200000000000005,439631547,0.568,2014,PG-13
105,The Da Vinci Code,760006945,217536138,0.28600000000000003,542470807,0.7140000000000001,2006,PG-13
106,Fast & Furious Presents: Hobbs & Shaw,759056935,173956935,0.22899999999999998,585100000,0.7709999999999999,2019,
107,Maleficent,758411779,241410378,0.318,517001401,0.682,2014,PG
108,The Amazing Spider-Man,757930663,262030663,0.34600000000000003,495900000,0.654,2012,PG-13
109,The Hunger Games: Mockingjay - Part 1,755356711,337135885,0.446,418220826,0.5539999999999999,2014,PG-13
110,Shrek Forever After,752600867,238736787,0.317,513864080,0.6829999999999999,2010,PG
111,Madagascar 3: Europe's Most Wanted,746921274,216391482,0.29,530529792,0.71,2012,PG
112,Suicide Squad,746846894,325100054,0.435,421746840,0.565,2016,PG-13
113,X-Men: Days of Future Past,746045700,233921534,0.314,512124166,0.6859999999999999,2014,PG-13
114,"The Chronicles of Narnia: The Lion, the Witch and the Wardrobe",745013115,291710957,0.392,453302158,0.608,2005,PG
115,Monsters University,743559645,268492764,0.361,475066881,0.639,2013,G
116,The Matrix Reloaded,741847937,281576461,0.38,460271476,0.62,2003,R
117,Up,735099102,293004164,0.39899999999999997,442094938,0.601,2009,PG
118,Ne Zha,726264074,3695533,0.005,722568541,0.995,2019,
119,F9: The Fast Saga,726229501,173005945,0.23800000000000002,553223556,0.762,2021,PG-13
120,Gravity,723192705,274092705,0.379,449100000,0.621,2013,PG-13
121,Captain America: The Winter Soldier,714421503,259766572,0.364,454654931,0.636,2014,PG-13
122,The Twilight Saga: Breaking Dawn - Part 1,712205856,281287133,0.395,430918723,0.605,2011,PG-13
123,The Twilight Saga: New Moon,711025481,297816253,0.419,413209228,0.581,2009,PG-13
124,Dawn of the Planet of the Apes,710644566,208545589,0.294,502098977,0.706,2014,PG-13
125,Transformers,709709780,319246193,0.45,390463587,0.55,2007,PG-13
126,The Amazing Spider-Man 2,708982323,202853933,0.28600000000000003,506128390,0.7140000000000001,2014,PG-13
127,It,701842551,328874981,0.469,372967570,0.531,2017,R
128,Interstellar,701729206,188020017,0.268,513709189,0.732,2014,PG-13
129,The Wandering Earth,699992512,5971413,0.008,694021099,0.992,2019,
130,The Twilight Saga: Eclipse,698491347,300531751,0.43,397959596,0.57,2010,PG-13
131,Mission: Impossible - Ghost Protocol,694713380,209397903,0.301,485315477,0.6990000000000001,2011,PG-13
132,The Hunger Games,694394724,408010692,0.588,286384032,0.41200000000000003,2012,PG-13
133,Detective Chinatown 3,686257563,,,686257563,1.0,2021,R
134,Mission: Impossible - Rogue Nation,682716636,195042377,0.28600000000000003,487674259,0.7140000000000001,2015,PG-13
135,Forrest Gump,678226133,330455270,0.48700000000000004,347770863,0.513,1994,PG-13
136,Doctor Strange,677796076,232641920,0.34299999999999997,445154156,0.657,2016,PG-13
137,The Sixth Sense,672806432,293506292,0.436,379300140,0.564,1999,PG-13
138,Man of Steel,668045518,291045518,0.436,377000000,0.564,2013,PG-13
139,Ice Age 2: The Meltdown,667094506,195330621,0.293,471763885,0.7070000000000001,2006,PG
140,Kung Fu Panda 2,665692281,165249063,0.248,500443218,0.752,2011,PG
141,The Hunger Games: Mockingjay - Part 2,658344137,281723902,0.428,376620235,0.5720000000000001,2015,PG-13
142,Justice League,657926987,229024295,0.348,428902692,0.652,2017,PG-13
143,Big Hero 6,657869686,222527828,0.33799999999999997,435341858,0.662,2014,PG
144,Fantastic Beasts: The Crimes of Grindelwald,654855901,159555901,0.244,495300000,0.7559999999999999,2018,PG-13
145,Pirates of the Caribbean: The Curse of the Black Pearl,654264015,305413918,0.467,348850097,0.5329999999999999,2003,PG-13
146,Star Wars: Episode II - Attack of the Clones,653779970,310676740,0.475,343103230,0.525,2002,PG
147,Thor: The Dark World,644783140,206362140,0.32,438421000,0.68,2013,PG-13
148,Moana,644136488,248757044,0.386,395379444,0.614,2016,PG
149,Sing,634338384,270578425,0.42700000000000005,363759959,0.573,2016,PG
150,Kung Fu Panda,632083197,215771591,0.341,416311606,0.659,2008,PG
151,The Incredibles,631607053,261441092,0.414,370165961,0.586,2004,
152,The Martian,630620818,228433663,0.36200000000000004,402187155,0.638,2015,PG-13
153,Hancock,629443428,227946274,0.36200000000000004,401497154,0.638,2008,PG-13
154,Fast Five,626137675,209837675,0.335,416300000,0.665,2011,PG-13
155,Men in Black 3,624026776,179020854,0.287,445005922,0.713,2012,PG-13
156,Iron Man 2,623933331,312433331,0.501,311500000,0.499,2010,PG-13
157,Ratatouille,623726085,206445654,0.331,417280431,0.669,2007,G
158,Ant-Man and the Wasp,622674139,216648740,0.348,406025399,0.652,2018,PG-13
159,How to Train Your Dragon 2,621537519,177002924,0.285,444534595,0.715,2014,PG
160,Logan,619179950,226277068,0.365,392902882,0.635,2017,R
161,The Lost World: Jurassic Park,618638999,229086679,0.37,389552320,0.63,1997,PG-13
162,Casino Royale,616502912,167445960,0.272,449056952,0.728,2006,PG-13
163,The Passion of the Christ,612054506,370782930,0.606,241271576,0.39399999999999996,2004,R
164,Mamma Mia!,611257819,144169664,0.23600000000000002,467088155,0.764,2008,PG-13
165,Life of Pi,609016565,124987023,0.205,484029542,0.795,2012,PG
166,The Batman,606578103,306178103,0.505,300400000,0.495,2022,PG-13
167,Transformers: The Last Knight,605425157,130168683,0.215,475256474,0.785,2017,PG-13
168,Madagascar: Escape 2 Africa,603900354,180010950,0.298,423889404,0.7020000000000001,2008,PG
169,War of the Worlds,603873119,234280354,0.38799999999999996,369592765,0.612,2005,PG-13
170,Tangled,592462816,200821936,0.33899999999999997,391640880,0.6609999999999999,2010,PG
171,Quantum of Solace,589580482,168368427,0.28600000000000003,421212055,0.7140000000000001,2008,PG-13
172,Men in Black,589390539,250690539,0.425,338700000,0.575,1997,PG-13
173,The Croods,587235983,187168425,0.319,400067558,0.6809999999999999,2013,PG
174,The Hangover Part II,586764305,254464305,0.434,332300000,0.5660000000000001,2011,R
175,Iron Man,585796247,319034126,0.545,266762121,0.455,2008,PG-13
176,I Am Legend,585410052,256393010,0.43799999999999994,329017042,0.562,2007,PG-13
177,Ready Player One,582918849,137715350,0.23600000000000002,445203499,0.764,2018,PG-13
178,"Monsters, Inc.",579707738,290642256,0.501,289065482,0.499,2001,G
179,Operation Red Sea,579330426,1543547,0.003,577786879,0.997,2018,
180,Night at the Museum,574481229,250863268,0.43700000000000006,323617961,0.563,2006,PG
181,Fifty Shades of Grey,569651467,166167230,0.292,403484237,0.708,2015,R
182,Kong: Skull Island,566652812,168052812,0.297,398600000,0.703,2017,PG-13
183,The Smurfs,563749323,142614158,0.253,421135165,0.747,2011,PG
184,Cars 2,559852396,191452396,0.342,368400000,0.6579999999999999,2011,G
185,King Kong,556906378,218080025,0.392,338826353,0.608,2005,PG-13
186,Puss in Boots,554987477,149260504,0.26899999999999996,405726973,0.731,2011,PG
187,The Mermaid,553810228,3232685,0.006,550577543,0.9940000000000001,2016,R
188,Armageddon,553709788,201578182,0.364,352131606,0.636,1998,PG-13
189,The Day After Tomorrow,552639571,186740799,0.33799999999999997,365898772,0.662,2004,PG-13
190,Ted,549368315,218815487,0.39799999999999996,330552828,0.602,2012,R
191,American Sniper,547459020,350159020,0.64,197300000,0.36,2014,R
192,Mission: Impossible II,546388108,215409889,0.39399999999999996,330978219,0.606,2000,PG-13
193,Detective Chinatown 2,544185156,1983984,0.004,542201172,0.996,2018,R
194,X-Men: Apocalypse,543934105,155442489,0.28600000000000003,388491616,0.7140000000000001,2016,PG-13
195,Sherlock Holmes: A Game of Shadows,543848418,186848418,0.344,357000000,0.6559999999999999,2011,PG-13
196,Despicable Me,543157985,251557985,0.46299999999999997,291600000,0.537,2010,PG
197,Cinderella,542358331,201151353,0.371,341206978,0.629,2015,PG
198,Madagascar,542063846,193595521,0.35700000000000004,348468325,0.643,2005,PG
199,World War Z,540455876,202807711,0.375,337648165,0.625,2013,PG-13
200,Brave,538983207,237283207,0.44,301700000,0.56,2012,PG
201,Star Wars: Episode V - The Empire Strikes Back,538375067,292753960,0.544,245621107,0.456,1980,PG
202,The Simpsons Movie,536414293,183135014,0.341,353279279,0.659,2007,PG-13
203,The Revenant,532950503,183637894,0.345,349312609,0.655,2015,R
204,The Meg,530517320,145522784,0.27399999999999997,384994536,0.726,2018,PG-13
205,Ralph Breaks the Internet,529323962,201091711,0.38,328232251,0.62,2018,PG
206,Hotel Transylvania 3: Summer Vacation,528583774,167510016,0.317,361073758,0.6829999999999999,2018,PG
207,The Boss Baby,527965936,175003033,0.332,352962903,0.6679999999999999,2017,PG
208,Dunkirk,527016307,189740665,0.36,337275642,0.64,2017,PG-13
209,Godzilla,524976069,200676069,0.382,324300000,0.618,2014,PG-13
210,How to Train Your Dragon: The Hidden World,524535083,160945505,0.307,363589578,0.693,2019,PG
211,Sherlock Holmes,524028679,209028679,0.39899999999999997,315000000,0.601,2009,PG-13
212,Meet the Fockers,522657936,279261160,0.534,243396776,0.466,2004,PG-13
213,WALL·E,521311890,223808164,0.429,297503726,0.5710000000000001,2008,
214,Kung Fu Panda 3,521170825,143528619,0.275,377642206,0.725,2016,PG
215,Terminator 2: Judgment Day,520881154,205881154,0.395,315000000,0.605,1991,R
216,Ant-Man,519311965,180202163,0.34700000000000003,339109802,0.653,2015,PG-13
217,The Grinch,512858819,271384731,0.529,241474088,0.47100000000000003,2018,PG
218,Ghost,505703557,217631306,0.43,288072251,0.57,1990,
219,Aladdin,504050219,217350219,0.431,286700000,0.569,1992,PG
220,Venom: Let There Be Carnage,502050366,213550366,0.425,288500000,0.575,2021,PG-13
221,Rio 2,498781117,131538435,0.264,367242682,0.736,2014,G
222,Troy,497409852,133378256,0.268,364031596,0.732,2004,R
223,Toy Story 2,497375381,245852179,0.494,251523202,0.506,1999,
224,How to Train Your Dragon,494879471,217581231,0.44,277298240,0.56,2010,PG
225,Twister,494580615,241830615,0.489,252750000,0.511,1996,
226,Oz the Great and Powerful,493311825,234911825,0.47600000000000003,258400000,0.524,2013,PG
227,Clash of the Titans,493214993,163214888,0.331,330000105,0.669,2010,PG-13
228,Maleficent: Mistress of Evil,491730089,113929605,0.23199999999999998,377800484,0.768,2019,PG
229,War for the Planet of the Apes,490719763,146880162,0.299,343839601,0.701,2017,PG-13
230,Shrek,488351320,268163011,0.5489999999999999,220188309,0.451,2001,PG
231,Mr. & Mrs. Smith,487287646,186336279,0.382,300951367,0.618,2005,PG-13
232,Angels & Demons,485930816,133375846,0.27399999999999997,352554970,0.726,2009,PG-13
233,Teenage Mutant Ninja Turtles,485004754,191204754,0.39399999999999996,293800000,0.606,2014,PG-13
234,Bruce Almighty,484592874,242829261,0.501,241763613,0.499,2003,PG-13
235,Rio,483866518,143619809,0.297,340246709,0.703,2011,PG
236,Saving Private Ryan,482349603,217049603,0.45,265300000,0.55,1998,R
237,Rise of the Planet of the Apes,481800873,176760185,0.36700000000000005,305040688,0.633,2011,PG-13
238,Water Gate Bridge,480203271,117294,0.001,480085977,1.0,2022,
239,Home Alone,476684675,285761243,0.6,190923432,0.4,1990,
240,Hotel Transylvania 2,475186706,169700110,0.35700000000000004,305486596,0.643,2015,PG
241,Star Wars: Episode VI - Return of the Jedi,475106177,309306177,0.6509999999999999,165800000,0.349,1983,PG
242,Charlie and the Chocolate Factory,474968763,206459076,0.435,268509687,0.565,2005,PG
243,Indiana Jones and the Last Crusade,474171806,197171806,0.41600000000000004,277000000,0.584,1989,PG-13
244,San Andreas,474009154,155190832,0.327,318818322,0.6729999999999999,2015,PG-13
245,It Chapter Two,473122525,211622525,0.447,261500000,0.5529999999999999,2019,R
246,Jaws,471411300,260758300,0.5529999999999999,210653000,0.447,1975,
247,Wreck-It Ralph,471222889,189422889,0.402,281800000,0.598,2012,PG
248,The Hangover,469328079,277339746,0.591,191988333,0.409,2009,R
249,The Lego Movie,468266122,257966122,0.551,210300000,0.449,2014,PG
250,Godzilla vs. Kong,468216094,100916094,0.21600000000000003,367300000,0.784,2021,PG-13
251,Bumblebee,467989645,127195589,0.272,340794056,0.728,2018,PG-13
252,Star Trek Into Darkness,467365246,228778661,0.49,238586585,0.51,2013,PG-13
253,The Matrix,467222728,172076928,0.368,295145800,0.632,1999,R
254,Gladiator,465380802,187705427,0.40299999999999997,277675375,0.597,2000,R
255,Pretty Woman,463406268,178406268,0.385,285000000,0.615,1990,R
256,Cars,461991867,244082982,0.528,217908885,0.47200000000000003,2006,
257,The Eight Hundred,461421559,372755,0.001,461048804,0.9990000000000001,2020,
258,X-Men: The Last Stand,460435291,234362462,0.509,226072829,0.491,2006,PG-13
259,National Treasure: Book of Secrets,459242249,219964115,0.479,239278134,0.521,2007,PG
260,Lucy,458863600,126663600,0.276,332200000,0.7240000000000001,2014,R
261,Mission: Impossible,457696391,180981856,0.395,276714535,0.605,1996,PG-13
262,300,456082343,210629101,0.462,245453242,0.5379999999999999,2007,R
263,Demon Slayer the Movie: Mugen Train,454779627,49505008,0.109,405274619,0.8909999999999999,2020,R
264,The Last Samurai,454627263,111127263,0.244,343500000,0.7559999999999999,2003,R
265,Dying to Survive,451183391,6752,,451176639,1.0,2018,
266,Ocean's Eleven,450717150,183417150,0.40700000000000003,267300000,0.593,2001,PG-13
267,"My People, My Country",450064993,2356683,0.005,447708310,0.995,2019,
268,Thor,449326618,181030624,0.40299999999999997,268295994,0.597,2011,PG-13
269,Pearl Harbor,449220945,198542554,0.442,250678391,0.5579999999999999,2001,PG-13
270,La La Land,448906865,151101803,0.337,297805062,0.6629999999999999,2016,PG-13
271,Tarzan,448191819,171091819,0.382,277100000,0.618,1999,G
272,Men in Black II,445135288,193735288,0.435,251400000,0.565,2002,PG-13
273,The Bourne Ultimatum,444100035,227471070,0.512,216628965,0.488,2007,PG-13
274,The Mummy Returns,443280904,202019785,0.456,241261119,0.544,2001,PG-13
275,Alvin and the Chipmunks: The Squeakquel,443140005,219614612,0.496,223525393,0.504,2009,PG
276,Les Misérables,442299309,148809770,0.336,293489539,0.664,2012,PG-13
277,The Exorcist,441306145,233005644,0.528,208300501,0.47200000000000003,1973,R
278,Mrs. Doubtfire,441286195,219195243,0.49700000000000005,222090952,0.503,1993,PG-13
279,Terminator Genisys,440603537,89760956,0.204,350842581,0.7959999999999999,2015,PG-13
280,Warcraft,439048914,47365290,0.10800000000000001,391683624,0.892,2016,PG-13
281,The Greatest Showman,436949634,174340174,0.39899999999999997,262609460,0.601,2017,PG
282,A Star Is Born,436233122,215333122,0.494,220900000,0.506,2018,R
283,Pokémon Detective Pikachu,433477601,144174568,0.33299999999999996,289303033,0.667,2019,PG
284,Terminator 3: Rise of the Machines,433371112,150371112,0.34700000000000003,283000000,0.653,2003,R
285,Shang-Chi and the Legend of the Ten Rings,432243292,224543292,0.52,207700000,0.48,2021,PG-13
286,Die Another Day,431971116,160942139,0.373,271028977,0.627,2002,PG-13
287,The Secret Life of Pets 2,430051293,158874395,0.369,271176898,0.631,2019,PG
288,Cast Away,429632142,233632142,0.544,196000000,0.456,2000,PG-13
289,Rampage,428028233,101028233,0.23600000000000002,327000000,0.764,2018,PG-13
290,The King's Speech,427374317,138797449,0.325,288576868,0.675,2010,R
291,The Matrix Revolutions,427344325,139313948,0.326,288030377,0.674,2003,R
292,The Intouchables,426588510,10198820,0.024,416389690,0.976,2011,R
293,Bad Boys for Life,426505244,206305244,0.484,220200000,0.516,2020,R
294,Django Unchained,426074373,162805434,0.382,263268939,0.618,2012,R
295,Beauty and the Beast,424967620,218967620,0.515,206000000,0.485,1991,PG
296,Dances with Wolves,424208848,184208848,0.434,240000000,0.5660000000000001,1990,
297,"My People, My Homeland",422390820,,,422390820,1.0,2020,
298,The Chronicles of Narnia: Prince Caspian,419665568,141621490,0.33799999999999997,278044078,0.662,2008,PG
299,Sex and the City,418765519,152647258,0.364,266118261,0.636,2008,R
300,The Captain,417282021,706572,0.002,416575449,0.998,2019,
301,The Mummy,415933406,155385488,0.374,260547918,0.626,1999,PG-13
302,The Chronicles of Narnia: The Voyage of the Dawn Treader,415686217,104386950,0.251,311299267,0.7490000000000001,2010,PG
303,Jason Bourne,415484914,162434410,0.391,253050504,0.609,2016,PG-13
304,The Wolverine,414828246,132556852,0.32,282271394,0.68,2013,PG-13
305,Kingsman: The Secret Service,414351546,128261724,0.31,286089822,0.69,2015,R
306,Night at the Museum: Battle of the Smithsonian,413106170,177243721,0.429,235862449,0.5710000000000001,2009,PG
307,Batman,411569241,251409241,0.611,160160000,0.389,1989,
308,The Bodyguard,411046449,122046449,0.297,289000000,0.703,1992,R
309,Pacific Rim,411002906,101802906,0.248,309200000,0.752,2013,PG-13
310,Kingsman: The Golden Circle,410902662,100234838,0.244,310667824,0.7559999999999999,2017,R
311,The Mummy,409231607,80227895,0.196,329003712,0.804,2017,PG-13
312,Ice Age 5: Collision Course,408754975,64063008,0.157,344691967,0.843,2016,PG
313,Twilight,408430415,193962473,0.475,214467942,0.525,2008,PG-13
314,Signs,408247917,227966634,0.5579999999999999,180281283,0.442,2002,PG-13
315,X2: X-Men United,407711549,214949694,0.527,192761855,0.473,2003,PG-13
316,Alita: Battle Angel,404980543,85838210,0.212,319142333,0.7879999999999999,2019,PG-13
317,The Mummy: Tomb of the Dragon Emperor,403449830,102491776,0.254,300958054,0.746,2008,PG-13
318,Prometheus,403354469,126477084,0.314,276877385,0.6859999999999999,2012,R
319,Gone with the Wind,402382193,200882193,0.499,201500000,0.501,1939,
320,Mamma Mia! Here We Go Again,402254384,120634935,0.3,281619449,0.7,2018,PG-13
321,Eternals,402064899,164870234,0.41,237194665,0.59,2021,PG-13
322,Dune,400580738,108236779,0.27,292343959,0.73,2021,PG-13
323,TRON: Legacy,400063852,172062763,0.43,228001089,0.57,2010,PG
324,Mission: Impossible III,398479497,134029801,0.336,264449696,0.664,2006,PG-13
325,Snow White and the Huntsman,396592829,155332381,0.392,241260448,0.608,2012,PG-13
326,Grease,396271103,190071103,0.48,206200000,0.52,1978,PG
327,Toy Story,394436586,223225679,0.5660000000000001,171210907,0.434,1995,
328,Solo: A Star Wars Story,392924807,213767512,0.544,179157295,0.456,2018,PG-13
329,The Wolf of Wall Street,392000694,116900694,0.298,275100000,0.7020000000000001,2013,R
330,Superman Returns,391081192,200081192,0.512,191000000,0.488,2006,PG-13
331,Robin Hood: Prince of Thieves,390493908,165493908,0.424,225000000,0.5760000000000001,1991,
332,Indiana Jones and the Raiders of the Lost Ark,389925971,248159971,0.636,141766000,0.364,1981,PG
333,Independence Day: Resurgence,389681935,103144286,0.265,286537649,0.735,2016,PG-13
334,Live Free or Die Hard,388156011,134529403,0.34700000000000003,253626608,0.653,2007,PG-13
335,Monster Hunt,387053506,32766,0.001,387020740,1.0,2015,
336,Godzilla: King of the Monsters,386600138,110500138,0.28600000000000003,276100000,0.7140000000000001,2019,PG-13
337,Home,386041607,177397510,0.46,208644097,0.54,2015,PG
338,Star Trek,385680446,257730019,0.6679999999999999,127950427,0.332,2009,PG-13
339,1917,384919389,159227644,0.414,225691745,0.586,2019,R
340,Happy Feet,384336108,198000317,0.515,186335791,0.485,2006,PG
341,Cars 3,383930656,152901115,0.39799999999999996,231029541,0.602,2017,G
342,Back to the Future,383336762,212836762,0.555,170500000,0.445,1985,
343,Ice Age,383257136,176387405,0.46,206869731,0.54,2002,PG
344,Fifty Shades Darker,381545846,114581250,0.3,266964596,0.7,2017,R
345,Monsters vs. Aliens,381509870,198351526,0.52,183158344,0.48,2009,PG
346,Black Widow,379751655,183651655,0.484,196100000,0.516,2021,PG-13
347,Godzilla,379014294,136314294,0.36,242700000,0.64,1998,PG-13
348,True Lies,378882411,146282411,0.386,232600000,0.614,1994,R
349,Slumdog Millionaire,378410542,141319928,0.374,237090614,0.626,2008,R
350,Sing 2,377386215,158716215,0.42100000000000004,218670000,0.579,2021,PG
351,Taken 2,376152455,139854287,0.37200000000000005,236298168,0.628,2012,PG-13
352,G.I. Joe: Retaliation,375740705,122523060,0.326,253217645,0.674,2013,PG-13
353,Mad Max: Fury Road,375709470,154109060,0.41,221600410,0.59,2015,R
354,Spider-Man: Into the Spider-Verse,375540831,190241310,0.507,185299521,0.493,2018,PG
355,Shark Tale,374583879,160861908,0.429,213721971,0.5710000000000001,2004,PG
356,Once Upon a Time... In Hollywood,374565754,142502728,0.38,232063026,0.62,2019,R
357,What Women Want,374111707,182811707,0.489,191300000,0.511,2000,PG-13
358,The Adventures of Tintin,373993951,77591831,0.20800000000000002,296402120,0.792,2011,PG
359,Batman Begins,373672993,206863479,0.5539999999999999,166809514,0.446,2005,PG-13
360,Penguins of Madagascar,373515621,83850911,0.22399999999999998,289664710,0.7759999999999999,2014,PG
361,X-Men Origins: Wolverine,373062864,179883157,0.48200000000000004,193179707,0.518,2009,PG-13
362,The Golden Compass,372234864,70107728,0.188,302127136,0.812,2007,PG-13
363,Fifty Shades Freed,371987838,100407760,0.27,271580078,0.73,2018,R
364,Hitch,371594210,179495555,0.483,192098655,0.517,2005,PG-13
365,Terminator Salvation,371353001,125322469,0.33799999999999997,246030532,0.662,2009,PG-13
366,Captain America: The First Avenger,370569774,176654505,0.47700000000000004,193915269,0.523,2011,PG-13
367,Edge of Tomorrow,370541256,100206256,0.27,270335000,0.73,2014,PG-13
368,There's Something About Mary,369884651,176484651,0.47700000000000004,193400000,0.523,1998,R
369,Gone Girl,369330363,167767189,0.45399999999999996,201563174,0.546,2014,R
370,The Fugitive,368875760,183875760,0.498,185000000,0.502,1993,PG-13
371,Jurassic Park III,368780809,181171875,0.491,187608934,0.509,2001,PG-13
372,My Big Fat Greek Wedding,368744044,241438208,0.655,127305836,0.345,2002,PG
373,Hello Mr. Billionaire,366961907,,,366961907,1.0,2018,
374,Die Hard with a Vengeance,366101666,100012499,0.273,266089167,0.727,1995,R
375,Shazam!,366080049,140480049,0.384,225600000,0.616,2019,PG-13
376,The Nun,365582797,117481222,0.321,248101575,0.679,2018,R
377,Alvin and the Chipmunks,365352546,217326974,0.595,148025572,0.405,2007,PG
378,Notting Hill,363889678,116089678,0.319,247800000,0.6809999999999999,1999,PG-13
379,Tenet,363704105,58504105,0.161,305200000,0.8390000000000001,2020,PG-13
380,A Bug's Life,363258859,162798565,0.44799999999999995,200460294,0.552,1998,
381,Night at the Museum: Secret of the Tomb,363204635,113746621,0.313,249458014,0.687,2014,PG
382,Ocean's Twelve,362744280,125544280,0.34600000000000003,237200000,0.654,2004,PG-13
383,Planet of the Apes,362211740,180011740,0.49700000000000005,182200000,0.503,2001,PG-13
384,The Hangover Part III,362000072,112200072,0.31,249800000,0.69,2013,R
385,The World Is Not Enough,361832400,126943684,0.35100000000000003,234888716,0.649,1999,PG-13
386,Monster Hunt 2,361682618,706153,0.002,360976465,0.998,2018,
387,Fast & Furious,360366870,155064265,0.43,205302605,0.57,2009,PG-13
388,Noah,359200044,101200044,0.282,258000000,0.718,2014,PG-13
389,The Karate Kid,359126022,176591618,0.49200000000000005,182534404,0.508,2010,PG
390,Home Alone 2: Lost in New York,358994850,173585516,0.484,185409334,0.516,1992,PG
391,Hotel Transylvania,358375603,148313048,0.414,210062555,0.586,2012,PG
392,Minority Report,358372926,132072926,0.368,226300000,0.632,2002,PG-13
393,Your Name.,358180115,5017246,0.013999999999999999,353162869,0.986,2016,PG
394,Top Gun,357288178,180258178,0.504,177030000,0.496,1986,
395,The Legend of Tarzan,356700357,126643061,0.355,230057296,0.645,2016,PG-13
396,American Beauty,356296601,130096601,0.365,226200000,0.635,1999,R
397,Spirited Away,355668961,13750644,0.039,341918317,0.961,2001,PG
398,Apollo 13,355237933,173837933,0.489,181400000,0.511,1995,PG
399,Rain Man,354825435,172825435,0.48700000000000004,182000000,0.513,1988,
400,The Great Gatsby,353659851,144857996,0.41,208801855,0.59,2013,PG-13
401,Dumbo,353284621,114766307,0.325,238518314,0.675,2019,PG
402,"I, Robot",353133898,144801023,0.41,208332875,0.59,2004,PG-13
403,Basic Instinct,352927224,117727224,0.33399999999999996,235200000,0.6659999999999999,1992,R
404,Murder on the Orient Express,352794081,102826543,0.292,249967538,0.708,2017,PG-13
405,X-Men: First Class,352616690,146408305,0.415,206208385,0.585,2011,PG-13
406,The Angry Birds Movie,352333929,107509366,0.305,244824563,0.695,2016,PG
407,GoldenEye,352194034,106429941,0.302,245764093,0.698,1995,PG-13
408,Catch Me If You Can,352114312,164615351,0.46799999999999997,187498961,0.532,2002,PG-13
409,Now You See Me,351723989,117723989,0.335,234000000,0.665,2013,PG-13
410,Hannibal,351692268,165092268,0.469,186600000,0.531,2001,R
411,The Mask,351583407,119938730,0.341,231644677,0.659,1994,PG-13
412,Peter Rabbit,351496066,115253424,0.32799999999999996,236242642,0.672,2018,PG
413,Speed,350448145,121248145,0.34600000000000003,229200000,0.654,1994,R
414,Dinosaur,349822765,137748063,0.39399999999999996,212074702,0.606,2000,PG
415,Mary Poppins Returns,349546142,171958438,0.49200000000000005,177587704,0.508,2018,PG
416,Deep Impact,349464664,140464664,0.402,209000000,0.598,1998,PG-13
417,The Lorax,349183316,214373500,0.614,134809816,0.386,2012,PG
418,The Maze Runner,348319861,102427862,0.294,245891999,0.706,2014,PG-13
419,The Smurfs 2,347545360,71017784,0.204,276527576,0.7959999999999999,2013,PG
420,National Treasure,347512318,173008894,0.498,174503424,0.502,2004,PG
421,Rush Hour 2,347325802,226164286,0.6509999999999999,121161516,0.349,2001,PG-13
422,Trolls,347182886,154025064,0.444,193157822,0.556,2016,PG
423,xXx: Return of Xander Cage,346118277,44898413,0.13,301219864,0.87,2017,PG-13
424,Pocahontas,346079773,141579773,0.409,204500000,0.591,1995,G
425,How the Grinch Stole Christmas,345823032,260715005,0.754,85108027,0.24600000000000002,2000,PG
426,Star Trek Beyond,343471816,158848340,0.462,184623476,0.5379999999999999,2016,PG-13
427,Alvin and the Chipmunks: Chipwrecked,342695435,133110742,0.38799999999999996,209584693,0.612,2011,G
428,Wanted,342463063,134508551,0.39299999999999996,207954512,0.607,2008,R
429,The Flintstones,341631208,130531208,0.382,211100000,0.618,1994,PG
430,A Quiet Place,340952971,188024361,0.552,152928610,0.44799999999999995,2018,PG-13
431,Enchanted,340487836,127807262,0.375,212680574,0.625,2007,PG
432,Over the Hedge,339795890,155019340,0.456,184776550,0.544,2006,PG
433,Uncharted,338651703,127251703,0.376,211400000,0.624,2022,PG-13
434,300: Rise of an Empire,337580051,106580051,0.316,231000000,0.684,2014,R
435,Batman Forever,336567158,184069126,0.547,152498032,0.45299999999999996,1995,PG-13
436,Prince of Persia: The Sands of Time,336365676,90759676,0.27,245606000,0.73,2009,PG-13
437,The Curious Case of Benjamin Button,335802786,127509326,0.38,208293460,0.62,2008,PG-13
438,Journey 2: The Mysterious Island,335287748,103887748,0.31,231400000,0.69,2012,PG
439,The Rock,335062621,134069511,0.4,200993110,0.6,1996,R
440,The Great Wall,334933831,45540830,0.136,289393001,0.8640000000000001,2016,PG-13
441,Now You See Me 2,334897606,65075540,0.19399999999999998,269822066,0.8059999999999999,2016,PG-13
442,Never Say Die,334530869,,,334530869,1.0,2017,
443,Fantastic Four,333535934,154696080,0.46399999999999997,178839854,0.536,2005,PG-13
444,Indiana Jones and the Temple of Doom,333107271,179870271,0.54,153237000,0.46,1984,
445,Tomorrow Never Dies,333011068,125304276,0.376,207706792,0.624,1997,PG-13
446,Back to the Future Part II,332500002,119000002,0.358,213500000,0.642,1989,
447,The Good Dinosaur,332207671,123087120,0.37,209120551,0.63,2015,PG
448,Free Guy,331526598,121626598,0.36700000000000005,209900000,0.633,2021,PG-13
449,22 Jump Street,331333876,191719337,0.579,139614539,0.42100000000000004,2014,R
450,Meet the Parents,330444045,166244045,0.503,164200000,0.49700000000000005,2000,PG-13
451,Who Framed Roger Rabbit,329803958,156452370,0.474,173351588,0.526,1988,
452,Black Swan,329398046,106954678,0.325,222443368,0.675,2010,R
453,The Perfect Storm,328718434,182618434,0.556,146100000,0.444,2000,PG-13
454,Crocodile Dundee,328203506,174803506,0.5329999999999999,153400000,0.467,1986,
455,Crazy Alien,327598891,,,327598891,1.0,2019,
456,Se7en,327333559,100125643,0.306,227207916,0.6940000000000001,1995,R
457,John Wick: Chapter 3 - Parabellum,327281779,171015687,0.522,156266092,0.478,2019,R
458,The Devil Wears Prada,326706115,124740460,0.382,201965655,0.618,2006,PG-13
459,Taken 3,326479141,89256424,0.273,237222717,0.727,2015,PG-13
460,The Hunchback of Notre Dame,325338851,100138851,0.308,225200000,0.6920000000000001,1996,
461,A Christmas Carol,325286646,137855863,0.424,187430783,0.5760000000000001,2009,PG
462,The SpongeBob Movie: Sponge Out of Water,325186032,162994032,0.501,162192000,0.499,2015,PG
463,Schindler's List,322161245,96898818,0.301,225262427,0.6990000000000001,1993,R
464,Megamind,321885765,148415853,0.461,173469912,0.539,2010,PG
465,The Conjuring 2,321834351,102516140,0.318,219318211,0.682,2016,R
466,Green Book,321752656,85080171,0.264,236672485,0.736,2018,PG-13
467,Lethal Weapon 3,321731527,144731527,0.45,177000000,0.55,1992,R
468,The Ugly Truth,321682600,88915214,0.276,232767386,0.7240000000000001,2009,R
469,Robin Hood,321669741,105269730,0.327,216400011,0.6729999999999999,2010,PG-13
470,Inglourious Basterds,321457747,120540719,0.375,200917028,0.625,2009,R
471,101 Dalmatians,320689294,136189294,0.425,184500000,0.575,1996,
472,The Conjuring,320406242,137446368,0.429,182959874,0.5710000000000001,2013,R
473,Fatal Attraction,320145693,156645693,0.489,163500000,0.511,1987,
474,Sonic the Hedgehog,319715683,148974665,0.466,170741018,0.534,2020,PG
475,The Last Airbender,319713881,131772187,0.41200000000000003,187941694,0.588,2010,PG
476,The Proposal,317375031,163958031,0.517,153417000,0.483,2009,PG-13
477,A Beautiful Mind,316791257,170742341,0.539,146048916,0.461,2001,PG-13
478,Beverly Hills Cop,316360478,234760478,0.742,81600000,0.258,1984,
479,The Polar Express,315249768,188969804,0.599,126279964,0.401,2004,
480,Air Force One,315156409,172956409,0.5489999999999999,142200000,0.451,1997,R
481,The Expendables 2,314975955,85028192,0.27,229947763,0.73,2012,R
482,Chicken Little,314432837,135386665,0.431,179046172,0.569,2005,G
483,As Good as It Gets,314178011,148478011,0.473,165700000,0.527,1997,PG-13
484,Maze Runner: The Scorch Trials,312296056,81697192,0.262,230598864,0.738,2015,PG-13
485,Resident Evil: The Final Chapter,312242626,26830068,0.086,285412558,0.914,2016,R
486,The Lego Batman Movie,312136671,175936671,0.564,136200000,0.436,2017,PG
487,Austin Powers: The Spy Who Shagged Me,312016928,206040086,0.66,105976842,0.34,1999,PG-13
488,Knives Out,311605581,165363234,0.531,146242347,0.469,2019,PG-13
489,Ocean's Thirteen,311312624,117154724,0.376,194157900,0.624,2007,PG-13
490,Little Fockers,310650585,148438600,0.478,162211985,0.522,2010,PG-13
491,Bolt,309979994,114053579,0.368,195926415,0.632,2008,PG
492,Ransom,309492681,136492681,0.441,173000000,0.5589999999999999,1996,R
493,Runaway Bride,309460292,152257509,0.49200000000000005,157202783,0.508,1999,PG
494,The Blind Side,309231694,255982860,0.828,53248834,0.172,2009,PG-13
495,The Ex-File 3: The Return of The Exes,307592427,838959,0.003,306753468,0.997,2017,
496,The Fault in Our Stars,307166834,124872350,0.406,182294484,0.594,2014,PG-13
497,The Pursuit of Happyness,307127625,163566459,0.5329999999999999,143561166,0.467,2006,PG-13
498,Rise of the Guardians,306941670,103412758,0.337,203528912,0.6629999999999999,2012,PG
499,Close Encounters of the Third Kind,306889114,135189114,0.44,171700000,0.56,1977,
500,Chicago,306776732,170687518,0.556,136089214,0.444,2002,PG-13
501,Annabelle: Creation,306515884,102092201,0.33299999999999996,204423683,0.667,2017,R
502,Wonder,306209289,132422809,0.43200000000000005,173786480,0.568,2017,PG
503,Skyscraper,304868961,68420120,0.22399999999999998,236448841,0.7759999999999999,2018,PG-13
504,A Good Day to Die Hard,304654182,67349198,0.221,237304984,0.779,2013,R
505,Mulan,304320254,120620254,0.396,183700000,0.604,1998,
506,Dangal,303723636,12391761,0.040999999999999995,291331875,0.9590000000000001,2016,
507,Passengers,303144152,100014699,0.33,203129453,0.67,2016,PG-13
508,Battleship,303025485,65422625,0.21600000000000003,237602860,0.784,2012,PG-13
509,Liar Liar,302710615,181410615,0.599,121300000,0.401,1997,PG-13
510,G.I. Joe: The Rise of Cobra,302469017,150201498,0.49700000000000005,152267519,0.503,2009,PG-13
511,Wrath of the Titans,301970083,83670083,0.27699999999999997,218300000,0.723,2012,PG-13
512,Fantastic 4: Rise of the Silver Surfer,301913131,131921738,0.43700000000000006,169991393,0.563,2007,PG
513,Hook,300854823,119654823,0.39799999999999996,181200000,0.602,1991,
514,Superman,300478449,134478449,0.44799999999999995,166000000,0.552,1978,PG
515,Rocky IV,300473716,127873716,0.426,172600000,0.574,1985,PG
516,Rambo: First Blood Part II,300400432,150415432,0.501,149985000,0.499,1985,
517,Resident Evil: Afterlife,300228084,60128566,0.2,240099518,0.8,2010,R
518,Van Helsing,300157638,120177084,0.4,179980554,0.6,2004,PG-13
519,Stuart Little,300135367,140035367,0.467,160100000,0.5329999999999999,1999,PG
520,Beverly Hills Cop II,299965036,153665036,0.512,146300000,0.488,1987,
521,Alice Through the Looking Glass,299820798,77041381,0.257,222779417,0.743,2016,PG
522,My Best Friend's Wedding,299288605,127120029,0.425,172168576,0.575,1997,PG-13
523,Real Steel,299268508,85468508,0.28600000000000003,213800000,0.7140000000000001,2011,PG-13
524,Horton Hears a Who!,298572799,154529439,0.518,144043360,0.48200000000000004,2008,
525,Ocean's Eight,297795726,140295726,0.47100000000000003,157500000,0.529,2018,PG-13
526,A Quiet Place Part II,297372261,160072261,0.5379999999999999,137300000,0.462,2021,PG-13
527,The Divergent Series: Insurgent,297002527,130179072,0.43799999999999994,166823455,0.562,2015,PG-13
528,Look Who's Talking,296999813,140088813,0.47200000000000003,156911000,0.528,1989,
529,Austin Powers in Goldmember,296938801,213307889,0.718,83630912,0.282,2002,PG-13
530,Ghostbusters,296578797,243578797,0.821,53000000,0.179,1984,
531,Miss Peregrine's Home for Peculiar Children,296482446,87242834,0.294,209239612,0.706,2016,PG-13
532,X-Men,296339528,157299718,0.531,139039810,0.469,2000,PG-13
533,Ferdinand,296069199,84410380,0.285,211658819,0.715,2017,PG
534,Shutter Island,294805697,128012934,0.434,166792763,0.5660000000000001,2010,R
535,Doctor Dolittle,294456605,144156605,0.49,150300000,0.51,1998,PG-13
536,Bee Movie,293514336,126631277,0.431,166883059,0.569,2007,PG
537,Salt,293503354,118311368,0.40299999999999997,175191986,0.597,2010,PG-13
538,G-Force,292817898,119436770,0.408,173381128,0.5920000000000001,2009,PG
539,The Departed,291480452,132399394,0.45399999999999996,159081058,0.546,2006,R
540,What Lies Beneath,291420351,155464351,0.534,135956000,0.466,2000,PG-13
541,Pacific Rim: Uprising,290930148,59874525,0.20600000000000002,231055623,0.794,2018,PG-13
542,The Bourne Supremacy,290835269,176241941,0.606,114593328,0.39399999999999996,2004,PG-13
543,Sex and the City 2,290745055,95347692,0.32799999999999996,195397363,0.672,2010,R
544,Shakespeare in Love,289317794,100317794,0.34700000000000003,189000000,0.653,1998,R
545,Divergent,288885818,150947895,0.522,137937923,0.478,2014,PG-13
546,Coming to America,288752301,128152301,0.444,160600000,0.556,1988,
547,Wedding Crashers,288485135,209273411,0.725,79211724,0.275,2005,R
548,Bridesmaids,288383523,169106725,0.586,119276798,0.414,2011,R
549,Maze Runner: The Death Cure,288175335,58032443,0.201,230142892,0.799,2018,PG-13
550,Casper,287928194,100328194,0.348,187600000,0.652,1995,PG
551,American Pie 2,287553595,145103595,0.505,142450000,0.495,2001,R
552,Pitch Perfect 2,287144079,184296230,0.642,102847849,0.358,2015,PG-13
553,The Green Mile,286801374,136801374,0.47700000000000004,150000000,0.523,1999,R
554,Oblivion,286168572,89107235,0.311,197061337,0.6890000000000001,2013,PG-13
555,Elysium,286140700,93050117,0.325,193090583,0.675,2013,R
556,Lethal Weapon 4,285444603,130444603,0.457,155000000,0.5429999999999999,1998,R
557,John Carter,284139100,73078100,0.257,211061000,0.743,2012,PG-13
558,Turbo,282570682,83028128,0.294,199542554,0.706,2013,PG
559,Paddington,282377683,76271832,0.27,206105851,0.73,2014,PG
560,Bridget Jones's Diary,281995610,71543427,0.254,210452183,0.746,2001,R
561,The Tourist,278780441,67631157,0.243,211149284,0.757,2010,PG-13
562,Split,278454417,138291365,0.49700000000000005,140163052,0.503,2017,PG-13
563,Scary Movie,278019771,157019771,0.565,121000000,0.435,2000,R
564,xXx,277448382,142109382,0.512,135339000,0.488,2002,PG-13
565,The Bourne Legacy,276144750,113203870,0.41,162940880,0.59,2012,PG-13
566,Mr. Peabody & Sherman,275698039,111506430,0.40399999999999997,164191609,0.596,2014,PG
567,Scooby-Doo,275678613,153322074,0.556,122356539,0.444,2002,PG
568,Lincoln,275293450,182207973,0.662,93085477,0.33799999999999997,2012,PG-13
569,Lara Croft: Tomb Raider,274703340,131168070,0.478,143535270,0.522,2001,PG-13
570,Tomb Raider,274650803,58250803,0.212,216400000,0.7879999999999999,2018,PG-13
571,The Expendables,274470394,103068524,0.376,171401870,0.624,2010,R
572,Cloudy with a Chance of Meatballs 2,274325949,119793567,0.43700000000000006,154532382,0.563,2013,PG
573,The Nutty Professor,273961019,128814019,0.47,145147000,0.53,1996,PG-13
574,Jerry Maguire,273552592,153952592,0.563,119600000,0.43700000000000006,1996,R
575,Bad Boys II,273339556,138608444,0.507,134731112,0.493,2003,R
576,Lilo & Stitch,273144151,145794338,0.534,127349813,0.466,2002,PG
577,The Silence of the Lambs,272742922,130742922,0.479,142000000,0.521,1991,
578,Grown Ups,271457301,162001186,0.597,109456115,0.40299999999999997,2010,PG-13
579,Neighbors,270665134,150157400,0.555,120507734,0.445,2014,R
580,The Firm,270248367,158348367,0.586,111900000,0.414,1993,R
581,We're the Millers,269994119,150394119,0.557,119600000,0.44299999999999995,2012,R
582,Gran Torino,269958228,148095302,0.5489999999999999,121862926,0.451,2008,R
583,"10,000 BC",269784201,94784201,0.35100000000000003,175000000,0.649,2008,PG-13
584,American Gangster,269755430,130164645,0.48200000000000004,139590785,0.518,2007,R
585,Epic,268426634,107518682,0.401,160907952,0.599,2013,PG
586,Exodus: Gods and Kings,268175631,65014513,0.242,203161118,0.758,2014,PG-13
587,Bambi,267447150,102247150,0.382,165200000,0.618,1942,G
588,The Princess and the Frog,267045765,104400899,0.391,162644866,0.609,2009,
589,Batman Returns,266915287,162924631,0.61,103990656,0.39,1992,PG-13
590,Indecent Proposal,266614059,106614059,0.4,160000000,0.6,1993,R
591,Something's Gotta Give,265328738,124728738,0.47,140600000,0.53,2003,PG-13
592,Bridget Jones: The Edge of Reason,265126918,40226215,0.152,224900703,0.848,2004,R
593,The Incredible Hulk,264770996,134806913,0.509,129964083,0.491,2008,PG-13
594,Waterworld,264218220,88246220,0.33399999999999996,175972000,0.6659999999999999,1995,PG-13
595,The Truman Show,264118201,125618201,0.47600000000000003,138500000,0.524,1998,PG
596,Charlie's Angels,264105545,125305545,0.474,138800000,0.526,2000,PG-13
597,The Fifth Element,263920180,63820180,0.242,200100000,0.758,1997,PG-13
598,Parasite,263020130,53369749,0.203,209650381,0.797,2019,R
599,Jumanji,262821940,100499940,0.382,162322000,0.618,1995,PG
600,Borat: Cultural Learnings of America for Make Benefit Glorious Nation of Kazakhstan,262552893,128505958,0.489,134046935,0.511,2006,R
601,Robots,262511490,128200012,0.488,134311478,0.512,2005,PG
602,Knight and Day,261989769,76423035,0.292,185566734,0.708,2008,PG-13
603,Total Recall,261317921,119412921,0.457,141905000,0.5429999999999999,1990,
604,This Is It,261183588,72091016,0.276,189092572,0.7240000000000001,2009,PG
605,Terminator: Dark Fate,261119292,62253077,0.23800000000000002,198866215,0.762,2019,R
606,The Lone Ranger,260502115,89302115,0.34299999999999997,171200000,0.657,2013,PG-13
607,Super 8,260095986,127004179,0.488,133091807,0.512,2011,PG-13
608,Mojin: The Lost Legend,259368448,1243810,0.005,258124638,0.995,2015,
609,Blade Runner 2049,259352064,92071675,0.355,167280389,0.645,2017,R
610,Charlie's Angels: Full Throttle,259175788,100830111,0.389,158345677,0.611,2003,PG-13
611,Rush Hour 3,258097122,140125968,0.5429999999999999,117971154,0.457,2007,PG-13
612,The Full Monty,257938649,45950122,0.17800000000000002,211988527,0.8220000000000001,1997,R
613,Kung Fu Yoga,257753889,362657,0.001,257391232,0.9990000000000001,2017,
614,Annabelle,257589721,84284252,0.327,173305469,0.6729999999999999,2014,R
615,The Village,256697520,114197520,0.445,142500000,0.555,2003,PG-13
616,Lost in Hong Kong,256283912,1302281,0.005,254981631,0.995,2015,
617,Erin Brockovich,256271286,125595205,0.49,130676081,0.51,2000,R
618,Pegasus,255863112,,,255863112,1.0,2019,
619,Get Out,255745157,176196665,0.6890000000000001,79548492,0.311,2016,R
620,Marley & Me,255743093,143153751,0.56,112589342,0.44,2008,PG
621,Halloween,255614941,159342015,0.623,96272926,0.377,2018,R
622,Us,255185482,175084580,0.6859999999999999,80100902,0.314,2019,R
623,Cliffhanger,255000211,84049211,0.33,170951000,0.67,1993,R
624,Baahubali 2: The Conclusion,254158390,20186659,0.079,233971731,0.9209999999999999,2017,
625,Babe,254134910,63658910,0.25,190476000,0.75,1995,
626,Men in Black: International,253890701,80001807,0.315,173888894,0.685,2019,PG-13
627,Wild Hogs,253625427,168273550,0.664,85351877,0.336,2007,PG-13
628,High School Musical 3: Senior Year,252909177,90559416,0.358,162349761,0.642,2008,G
629,Hercules,252712101,99112101,0.392,153600000,0.608,1997,
630,X-Men: Dark Phoenix,252442974,65845974,0.261,186597000,0.7390000000000001,2019,PG-13
631,True Grit,252276927,171243005,0.679,81033922,0.321,2010,PG-13
632,Encanto,251664150,95934164,0.381,155729986,0.619,2021,PG
633,Bean,251212670,45319423,0.18,205893247,0.82,1997,PG-13
634,American Hustle,251171807,150117807,0.598,101054000,0.402,2013,R
635,Enemy of the State,250849789,111549836,0.445,139299953,0.555,1998,R
636,You've Got Mail,250821495,115821495,0.462,135000000,0.5379999999999999,1998,PG
637,Eragon,250425512,75030163,0.3,175395349,0.7,2006,PG
638,Brother Bear,250397798,85336277,0.341,165061521,0.659,2003,
639,The Mask of Zorro,250288523,94095523,0.376,156193000,0.624,1998,PG-13
640,The Godfather,250285894,136326869,0.545,113959025,0.455,1972,
641,The Ring,249348933,129128133,0.518,120220800,0.48200000000000004,2002,PG-13
642,The Blair Witch Project,248639099,140539099,0.565,108100000,0.435,1999,R
643,Unbreakable,248118121,95011339,0.38299999999999995,153106782,0.617,2000,PG-13
644,Journey to the West: The Demons Strike Back,247585244,880346,0.004,246704898,0.996,2017,PG-13
645,Dumb and Dumber,247290327,127190327,0.514,120100000,0.486,1994,
646,Glass,246999039,111048468,0.45,135950571,0.55,2019,PG-13
647,Grown Ups 2,246984278,133668525,0.541,113315753,0.45899999999999996,2013,PG-13
648,The Peanuts Movie,246233113,130178411,0.529,116054702,0.47100000000000003,2015,G
649,Rango,245724603,123477607,0.502,122246996,0.498,2011,PG
650,Four Weddings and a Funeral,245700832,52700832,0.214,193000000,0.7859999999999999,1994,R
651,Face/Off,245676146,112276146,0.457,133400000,0.5429999999999999,1997,R
652,Teenage Mutant Ninja Turtles: Out of the Shadows,245623848,82051601,0.33399999999999996,163572247,0.6659999999999999,2016,PG-13
653,Dark Shadows,245527149,79727149,0.325,165800000,0.675,2012,PG-13
654,Dolittle,245438444,77047065,0.314,168391379,0.6859999999999999,2020,PG
655,Hulk,245285165,132177234,0.539,113107931,0.461,2003,PG-13
656,Love Actually,245203167,59696144,0.244,185507023,0.7559999999999999,2003,R
657,The Bravest,245179562,290217,0.001,244889345,0.9990000000000001,2019,PG-13
658,Welcome to the Sticks,245144417,,,245144417,1.0,2008,
659,Back to the Future Part III,245077583,88277583,0.36,156800000,0.64,1990,
660,Pixels,244874809,78747585,0.322,166127224,0.6779999999999999,2015,PG-13
661,Hercules,244819862,72688614,0.297,172131248,0.703,2014,
662,Rush Hour,244721064,141186864,0.5770000000000001,103534200,0.423,1998,PG-13
663,Journey to the Center of the Earth,244232688,101704370,0.41600000000000004,142528318,0.584,2008,PG
664,After Earth,243611982,60522097,0.248,183089885,0.752,2013,PG-13
665,A Few Good Men,243240178,141340178,0.581,101900000,0.419,1992,R
666,Cloudy with a Chance of Meatballs,243006126,124870275,0.514,118135851,0.486,2009,PG
667,8 Mile,242875078,116750901,0.48100000000000004,126124177,0.519,2002,R
668,Daddy's Home,242786137,150357137,0.619,92429000,0.381,2015,PG-13
669,RoboCop,242688965,58607007,0.242,184081958,0.758,2014,PG-13
670,Eraser,242295562,101295562,0.418,141000000,0.5820000000000001,1996,R
671,Alien: Covenant,240891763,74262031,0.308,166629732,0.6920000000000001,2017,R
672,Sully,240797623,125070033,0.519,115727590,0.48100000000000004,2016,PG-13
673,Assassin's Creed,240697856,54647948,0.22699999999999998,186049908,0.773,2016,PG-13
674,Click,240685326,137355633,0.5710000000000001,103329693,0.429,2006,PG-13
675,Legend of Deification,240663149,214670,0.001,240448479,0.9990000000000001,2020,
676,Resident Evil: Retribution,240159255,42345531,0.17600000000000002,197813724,0.8240000000000001,2012,R
677,Die Hard 2,240031274,117540947,0.49,122490327,0.51,1990,
678,Crocodile Dundee II,239606210,109306210,0.456,130300000,0.544,1988,
679,Planes,239258712,90288712,0.377,148970000,0.623,2013,PG
680,Crazy Rich Asians,238843729,174837452,0.732,64006277,0.268,2018,PG-13
681,Batman & Robin,238235719,107353792,0.451,130881927,0.5489999999999999,1997,PG-13
682,Downton Abbey,237860050,96854135,0.40700000000000003,141005915,0.593,2019,PG
683,Gulliver's Travels,237382724,42779261,0.18,194603463,0.82,2010,PG
684,Gone in 60 Seconds,237202299,101648571,0.428,135553728,0.5720000000000001,2000,PG-13
685,Saturday Night Fever,237113184,94213184,0.397,142900000,0.603,1977,R
686,Silver Linings Playbook,236412453,132092958,0.5589999999999999,104319495,0.441,2012,R
687,2 Fast 2 Furious,236350661,127154901,0.5379999999999999,109195760,0.462,2003,PG-13
688,Howl's Moving Castle,236269142,5576743,0.024,230692399,0.976,2004,PG
689,Hidden Figures,235956898,169607287,0.7190000000000001,66349611,0.281,2016,PG
690,A.I. Artificial Intelligence,235926552,78616689,0.33299999999999996,157309863,0.667,2001,PG-13
691,Dead Poets Society,235860116,95860116,0.406,140000000,0.594,1989,
692,Spy,235666219,110825712,0.47,124840507,0.53,2015,R
693,American Pie,235483004,102561004,0.436,132922000,0.564,1999,R
694,American Reunion,234989584,57011521,0.243,177978063,0.757,2012,R
695,Big Daddy,234801895,163479795,0.696,71322100,0.304,1999,PG-13
696,Alvin and the Chipmunks: The Road Chip,234798636,85886987,0.366,148911649,0.634,2015,PG
697,The Imitation Game,233555708,91125683,0.39,142430025,0.61,2014,PG-13
698,Cruella,233503234,86103234,0.369,147400000,0.631,2021,PG-13
699,The Day the Earth Stood Still,233093859,79366978,0.34,153726881,0.66,2008,PG-13
700,American Wedding,232722935,104565114,0.449,128157821,0.551,2003,R
701,The Girl with the Dragon Tattoo,232617430,102515793,0.441,130101637,0.5589999999999999,2011,R
702,Juno,232372681,143495265,0.618,88877416,0.382,2007,PG-13
703,Argo,232325503,136025503,0.586,96300000,0.414,2012,R
704,Mr. Bean's Holiday,232225908,33302167,0.14300000000000002,198923741,0.857,2007,G
705,The English Patient,231976425,78676425,0.33899999999999997,153300000,0.6609999999999999,1996,R
706,Sister Act,231605150,139605150,0.603,92000000,0.397,1992,PG
707,Annabelle Comes Home,231252591,74152591,0.321,157100000,0.679,2019,R
708,Constantine,230884728,75976178,0.32899999999999996,154908550,0.6709999999999999,2005,R
709,Get Smart,230685453,130319208,0.565,100366245,0.435,2008,PG-13
710,Space Jam,230594962,90594962,0.39299999999999996,140000000,0.607,1996,PG
711,Life Is Beautiful,230098753,57563264,0.25,172535489,0.75,1998,PG-13
712,The Heat,229930771,159582188,0.6940000000000001,70348583,0.306,1996,R
713,Ghostbusters,229147509,128350574,0.56,100796935,0.44,2016,
714,Ghost Rider,228738393,115802596,0.506,112935797,0.494,2007,PG-13
715,Goodbye Mr. Loser,228122928,1293626,0.006,226829302,0.9940000000000001,2015,
716,Paddington 2,227994792,40907738,0.179,187087054,0.821,2017,PG
717,Sleepless in Seattle,227927165,126808165,0.556,101119000,0.444,1993,PG
718,Lethal Weapon 2,227853986,147253986,0.6459999999999999,80600000,0.354,1989,R
719,The Green Hornet,227817248,98780042,0.434,129037206,0.5660000000000001,2011,PG-13
720,Out of Africa,227514205,87071205,0.38299999999999995,140443000,0.617,1985,
721,Youth,227091290,1891956,0.008,225199334,0.992,2017,
722,Baby Driver,226945087,107825862,0.475,119119225,0.525,2017,R
723,Immortals,226904017,83504017,0.368,143400000,0.632,2011,R
724,Taken,226837760,145000989,0.639,81836771,0.361,2008,PG-13
725,Percy Jackson & the Olympians: The Lightning Thief,226497209,88768303,0.392,137728906,0.608,2010,PG
726,Hansel & Gretel: Witch Hunters,226349749,55703475,0.24600000000000002,170646274,0.754,2013,R
727,Valerian and the City of a Thousand Planets,225973340,41189488,0.182,184783852,0.818,2017,PG-13
728,Good Will Hunting,225933435,138433435,0.613,87500000,0.387,1997,R
729,Better Days,225918798,1921657,0.008,223997141,0.992,2019,
730,Ford v Ferrari,225508210,117624357,0.522,107883853,0.478,2019,PG-13
731,Jumper,225132113,80172128,0.35600000000000004,144959985,0.644,2008,PG-13
732,Elf,225097437,177874109,0.79,47223328,0.21,2003,PG
733,The Social Network,224920375,96962694,0.431,127957681,0.569,2010,PG-13
734,Chicken Run,224834564,106834564,0.475,118000000,0.525,2000,
735,Con Air,224012234,101117573,0.451,122894661,0.5489999999999999,1997,R
736,Interview with the Vampire: The Vampire Chronicles,223664608,105264608,0.47100000000000003,118400000,0.529,1994,R
737,Flightplan,223387299,89707299,0.402,133680000,0.598,2005,PG-13
738,Yes Man,223241637,97690976,0.43799999999999994,125550661,0.562,2008,PG-13
739,Non-Stop,222809600,92168600,0.414,130641000,0.586,2014,PG-13
740,"Honey, I Shrunk the Kids",222724172,130724172,0.5870000000000001,92000000,0.413,1989,
741,Fahrenheit 9/11,222446882,119194771,0.536,103252111,0.46399999999999997,2004,R
742,Wild Wild West,222104681,113804681,0.512,108300000,0.488,1999,PG-13
743,"My Country, My Parents",221701823,166807,0.001,221535016,0.9990000000000001,2021,
744,Geostorm,221600160,33700160,0.152,187900000,0.848,2017,PG-13
745,Presumed Innocent,221303188,86303188,0.39,135000000,0.61,1990,
746,Jungle Cruise,220889446,116987516,0.53,103901930,0.47,2021,PG-13
747,Scary Movie 3,220673217,110003217,0.498,110670000,0.502,2003,PG-13
748,Collateral,220239925,101005703,0.45899999999999996,119234222,0.541,2004,R
749,Inferno,220021259,34343574,0.156,185677685,0.8440000000000001,2016,PG-13
750,Knocked Up,219922417,148768917,0.6759999999999999,71153500,0.324,2007,R
751,Green Lantern,219851172,116601172,0.53,103250000,0.47,2011,PG-13
752,What Happens in Vegas,219375562,80277646,0.366,139097916,0.634,2008,PG-13
753,It's Complicated,219103655,112735375,0.514,106368280,0.486,2009,R
754,The Terminal,219100084,77872883,0.355,141227201,0.645,2004,PG-13
755,Captain Phillips,218791811,107100855,0.49,111690956,0.51,2013,PG-13
756,The Prince of Egypt,218613188,101413188,0.46399999999999997,117200000,0.536,1998,PG
757,Jack Reacher,218340595,80070736,0.36700000000000005,138269859,0.633,2012,PG-13
758,Kingdom of Heaven,218122627,47398413,0.217,170724214,0.7829999999999999,2005,R
759,The Emoji Movie,217776646,86089513,0.395,131687133,0.605,2017,PG
760,Too Cool to Kill,217255728,185882,0.001,217069846,0.9990000000000001,2022,
761,Dracula Untold,217124280,56280355,0.259,160843925,0.741,2014,PG-13
762,Central Intelligence,216972543,127440871,0.5870000000000001,89531672,0.413,2016,PG-13
763,Million Dollar Baby,216763646,100492203,0.46399999999999997,116271443,0.536,2004,PG-13
764,The Help,216639112,169708112,0.7829999999999999,46931000,0.217,2011,PG-13
765,Twins,216614388,111938388,0.517,104676000,0.483,1988,
766,Little Women,216601214,108101214,0.499,108500000,0.501,2019,PG
767,Valentine's Day,216528528,110528528,0.51,106000000,0.49,2010,PG-13
768,Bad Teacher,216197492,100292856,0.46399999999999997,115904636,0.536,2011,R
769,A Little Red Flower,216000000,,,216000000,1.0,2020,
770,The Croods 2: A New Age,215905815,58568815,0.271,157337000,0.7290000000000001,2020,PG
771,Clear and Present Danger,215887717,122187717,0.5660000000000001,93700000,0.434,1994,PG-13
772,One Hundred and One Dalmatians,215880014,144880014,0.6709999999999999,71000000,0.32899999999999996,1961,
773,Ted 2,215863606,81476385,0.377,134387221,0.623,2015,R
774,Bram Stoker's Dracula,215862692,82522790,0.382,133339902,0.618,1992,R
775,Vertical Limit,215663859,69243859,0.321,146420000,0.679,2000,PG-13
776,Ghostbusters II,215394738,112494738,0.522,102900000,0.478,1989,
777,The Patriot,215294342,113330342,0.526,101964000,0.474,2000,R
778,The Sorcerer's Apprentice,215283742,63150991,0.293,152132751,0.7070000000000001,2010,PG
779,Just Go with It,214945591,103028109,0.479,111917482,0.521,2011,PG-13
780,The Expendables 3,214657577,39322544,0.183,175335033,0.8170000000000001,2014,PG-13
781,Dirty Dancing,214577242,64577242,0.301,150000000,0.6990000000000001,1987,
782,Creed II,214215889,115715889,0.54,98500000,0.46,2018,PG-13
783,Smallfoot,214115531,83315531,0.389,130800000,0.611,2018,PG
784,Public Enemies,214104620,97104620,0.45399999999999996,117000000,0.546,2009,R
785,The Bourne Identity,214034224,121661683,0.568,92372541,0.43200000000000005,2002,PG-13
786,Disclosure,214015089,83015089,0.38799999999999996,131000000,0.612,1994,R
787,Pulp Fiction,213928762,107928762,0.504,106000000,0.496,1994,R
788,The Aviator,213719942,102610330,0.48,111109612,0.52,2004,PG-13
789,"Crouching Tiger, Hidden Dragon",213525736,128078872,0.6,85446864,0.4,2000,PG-13
790,Braveheart,213216216,75609945,0.355,137606271,0.645,1995,R
791,Into the Woods,212902372,128002372,0.601,84900000,0.39899999999999997,2014,PG
792,Bedtime Stories,212874864,110101975,0.517,102772889,0.483,2008,PG
793,Miss Congeniality,212742720,106807667,0.502,105935053,0.498,2000,PG-13
794,Entrapment,212404396,87704396,0.413,124700000,0.5870000000000001,1999,PG-13
795,Ace Ventura: When Nature Calls,212385533,108385533,0.51,104000000,0.49,1995,PG-13
796,End of Days,211989043,66889043,0.316,145100000,0.684,1999,R
797,Bridget Jones's Baby,211952420,24252420,0.114,187700000,0.8859999999999999,2016,R
798,Fury,211822697,85817906,0.405,126004791,0.595,2014,R
799,Battle Los Angeles,211819354,83552429,0.39399999999999996,128266925,0.606,2011,PG-13
800,Australia,211787511,49554002,0.23399999999999999,162233509,0.7659999999999999,2008,PG-13
801,Due Date,211780824,100539043,0.475,111241781,0.525,2010,R
802,Master and Commander: The Far Side of the World,211622535,93927920,0.444,117694615,0.556,2003,PG-13
803,A Series of Unfortunate Events,211468235,118634549,0.561,92833686,0.439,2004,PG
804,The Little Mermaid,211343479,111543479,0.528,99800000,0.47200000000000003,1989,
805,District 9,210888950,115646235,0.5479999999999999,95242715,0.452,2009,R
806,Moonraker,210308099,70308099,0.33399999999999996,140000000,0.6659999999999999,1979,
807,The Others,209947037,96522687,0.46,113424350,0.54,2001,PG-13
808,Horrible Bosses,209838559,117538559,0.56,92300000,0.44,2011,R
809,Us and Them,209221380,,,209221380,1.0,2018,
810,Red Dragon,209196298,93149898,0.445,116046400,0.555,2002,R
811,Tomorrowland,209035668,93436322,0.447,115599346,0.5529999999999999,2015,PG
812,Me Before You,208314186,56245075,0.27,152069111,0.73,2016,PG-13
813,Safe House,208076205,126373434,0.607,81702771,0.39299999999999996,2012,R
814,S.W.A.T.,207725639,116934650,0.563,90790989,0.43700000000000006,2003,PG-13
815,The Fast and the Furious,207517509,144745925,0.698,62771584,0.302,2001,PG-13
816,Traffic,207515725,124115725,0.598,83400000,0.402,2000,R
817,Paranormal Activity 3,207039844,104028807,0.502,103011037,0.498,2011,R
818,Philadelphia,206678440,77446440,0.375,129232000,0.625,1993,PG-13
819,Sleepy Hollow,206071502,101071502,0.49,105000000,0.51,1999,R
820,The Holiday,205850134,63224849,0.307,142625285,0.693,2006,PG-13
821,Raging Fire,205846481,385305,0.002,205461176,0.998,2021,
822,The Jungle Book,205843612,141843612,0.6890000000000001,64000000,0.311,1967,PG
823,London Has Fallen,205754447,62524260,0.304,143230187,0.696,2016,R
824,The Break-Up,205668210,118703275,0.5770000000000001,86964935,0.423,2006,PG-13
825,Journey to the West,205637183,18058,0.001,205619125,1.0,2013,PG-13
826,JFK,205405498,70405498,0.34299999999999997,135000000,0.657,1991,R
827,White House Down,205366737,73103784,0.35600000000000004,132262953,0.644,2013,PG-13
828,A Dog's Purpose,205035819,64508620,0.315,140527199,0.685,2017,PG
829,Ponyo,204826668,15743471,0.077,189083197,0.9229999999999999,2008,
830,Fun with Dick and Jane,204681899,110332737,0.539,94349162,0.461,2005,PG-13
831,Eat Pray Love,204594016,80574010,0.39399999999999996,124020006,0.606,2010,PG-13
832,You Don't Mess with the Zohan,204313400,100018837,0.49,104294563,0.51,2008,PG-13
833,The Addams Family,203783845,100723831,0.494,103060014,0.506,2019,PG
834,Hairspray,203627753,118946291,0.584,84681462,0.41600000000000004,2007,PG
835,King Arthur,203567857,51882244,0.255,151685613,0.745,2004,PG-13
836,Yogi Bear,203509374,100246011,0.493,103263363,0.507,2010,PG
837,Everest,203427584,43482270,0.214,159945314,0.7859999999999999,2015,PG-13
838,Vanilla Sky,203388341,100618344,0.495,102769997,0.505,2001,R
839,Arrival,203388186,100546139,0.494,102842047,0.506,2016,PG-13
840,Need for Speed,203277636,43577636,0.214,159700000,0.7859999999999999,2014,PG-13
841,Garfield,203172417,75369589,0.371,127802828,0.629,2004,PG
842,Patch Adams,202292902,135026902,0.6679999999999999,67266000,0.332,1998,PG-13
843,Teenage Mutant Ninja Turtles,202084756,135384756,0.67,66700000,0.33,1990,PG-13
844,The Conjuring: The Devil Made Me Do It,202031050,65631050,0.325,136400000,0.675,2021,R
845,Kindergarten Cop,201957688,91457688,0.45299999999999996,110500000,0.547,1990,
846,Birds of Prey,201872791,84172791,0.41700000000000004,117700000,0.583,2020,R
847,Straight Outta Compton,201634991,161197785,0.8,40437206,0.2,2015,R
848,21 Jump Street,201585328,138447667,0.687,63137661,0.313,2012,R
849,Valkyrie,201545517,83077833,0.41200000000000003,118467684,0.588,2008,PG-13
850,Open Season,200811689,85105259,0.424,115706430,0.5760000000000001,2006,PG
851,Cats & Dogs,200687492,93385515,0.465,107301977,0.535,2001,PG
852,The Hunt for Red October,200512643,122012643,0.608,78500000,0.392,1990,
853,Percy Jackson: Sea of Monsters,199850315,68559554,0.34299999999999997,131290761,0.657,2013,PG
854,Two Weeks Notice,199043471,93354851,0.469,105688620,0.531,2002,PG-13
855,RED,199006387,90380162,0.45399999999999996,108626225,0.546,2010,PG-13
856,Shock Wave 2,198921659,,,198921659,1.0,2020,
857,City of Angels,198685114,78685114,0.396,120000000,0.604,1998,PG-13
858,The Pacifier,198636868,113086868,0.569,85550000,0.431,2005,PG
859,50 First Dates,198520934,120908074,0.609,77612860,0.391,2004,PG-13
860,Total Recall,198467168,58877969,0.297,139589199,0.703,2012,
861,The Island,198326350,670883,0.003,197655467,0.997,2018,
862,The Impossible,198087212,19019882,0.096,179067330,0.904,2012,PG-13
863,Lost in Thailand,197757387,57387,0.001,197700000,1.0,2012,
864,Christopher Robin,197744377,99215042,0.502,98529335,0.498,2018,PG
865,Jack the Giant Slayer,197687603,65187603,0.33,132500000,0.67,2013,PG-13
866,Ghostbusters: Afterlife,197360575,129360575,0.6559999999999999,68000000,0.344,2021,PG-13
867,Smurfs: The Lost Village,197183546,45020282,0.228,152163264,0.772,2017,PG
868,Chinese Doctors,197143218,,,197143218,1.0,2021,
869,Spy Kids 3: Game Over,197101678,111761982,0.5670000000000001,85339696,0.433,2003,PG
870,Panic Room,197079546,96397334,0.489,100682212,0.511,2002,R
871,The Other Woman,196710396,83911193,0.42700000000000005,112799203,0.573,2014,PG-13
872,Stargate,196567262,71567262,0.364,125000000,0.636,1994,PG-13
873,Beowulf,196393745,82280579,0.419,114113166,0.581,2007,PG-13
874,The Vow,196114570,125014030,0.638,71100540,0.36200000000000004,2012,PG-13
875,Anger Management,195745823,135645823,0.693,60100000,0.307,2003,PG-13
876,Tropic Thunder,195702963,110515313,0.565,85187650,0.435,2008,R
877,The Shape of Water,195333312,63859435,0.327,131473877,0.6729999999999999,2017,R
878,Rocketman,195320400,96368160,0.493,98952240,0.507,2019,R
879,The Pelican Brief,195268056,100768056,0.516,94500000,0.484,1993,PG-13
880,The BFG,195243411,55483770,0.284,139759641,0.716,2016,PG
881,The Intern,194564672,75764672,0.389,118800000,0.611,2015,PG-13
882,Wallace & Gromit: The Curse of the Were-Rabbit,194137091,56110897,0.289,138026194,0.711,2005,
883,Gnomeo & Juliet,193967670,99967670,0.515,94000000,0.485,2011,
884,Weathering with You,193932489,8056636,0.042,185875853,0.958,2019,PG-13
885,The Sum of All Fears,193921372,118907036,0.613,75014336,0.387,2002,PG-13
886,Gangs of New York,193772504,77812000,0.402,115960504,0.598,2002,R
887,The Monkey King 2,193678298,709982,0.004,192968316,0.996,2016,
888,Paranormal Activity,193355800,107918810,0.5579999999999999,85436990,0.442,2009,R
889,The Lego Movie 2: The Second Part,192456290,105956290,0.55,86500000,0.45,2019,PG
890,The Equalizer,192330738,101530738,0.528,90800000,0.47200000000000003,2014,R
891,Sheep Without a Shepherd,191602146,,,191602146,1.0,2019,
892,The Addams Family,191502426,113502426,0.593,78000000,0.40700000000000003,1991,PG
893,The Longest Yard,191466556,158119460,0.826,33347096,0.174,2005,PG-13
894,The Santa Clause,190539357,145539357,0.764,45000000,0.23600000000000002,1994,PG
895,Cheaper by the Dozen,190538630,138614544,0.728,51924086,0.272,2003,PG
896,The Equalizer 2,190400157,102084362,0.536,88315795,0.46399999999999997,2018,R
897,Hollow Man,190213455,73209340,0.385,117004115,0.615,2000,R
898,Outbreak,189859560,67659560,0.35600000000000004,122200000,0.644,1995,R
899,The White Storm 2: Drug Lords,189396380,609461,0.003,188786919,0.997,2019,
900,The X Files,189176423,83898313,0.444,105278110,0.556,1998,PG-13
901,Breakup Buddies,189017596,777896,0.004,188239700,0.996,2014,
902,Rambo III,189015611,53715611,0.284,135300000,0.716,1988,
903,The Secret Life of Walter Mitty,188133322,58236838,0.31,129896484,0.69,2013,PG
904,Project Gutenberg,188116796,,,188116796,1.0,2018,
905,Jaws 2,187884007,81766007,0.435,106118000,0.565,1978,
906,12 Years a Slave,187733202,56671993,0.302,131061209,0.698,2013,R
907,Heat,187436818,67436818,0.36,120000000,0.64,1995,R
908,Mr. Popper's Penguins,187361754,68224452,0.364,119137302,0.636,2011,PG
909,The Grudge,187281115,110359362,0.589,76921753,0.41100000000000003,2004,PG-13
910,I Now Pronounce You Chuck & Larry,187134117,120059556,0.642,67074561,0.358,2007,PG-13
911,The Horse Whisperer,186883563,75383563,0.40299999999999997,111500000,0.597,1998,PG-13
912,Walk the Line,186797986,119519402,0.64,67278584,0.36,2005,PG-13
913,Jian Bing Man,186699768,,,186699768,1.0,2015,
914,The Jungle Book 2,186303759,47901582,0.257,138402177,0.743,2003,
915,The Final Destination,186167139,66477700,0.35700000000000004,119689439,0.643,2009,R
916,Atlantis: The Lost Empire,186053725,84056472,0.452,101997253,0.5479999999999999,2001,PG
917,Inside Man,186003591,88513495,0.47600000000000003,97490096,0.524,2006,R
918,The Waterboy,185991646,161491646,0.868,24500000,0.132,1998,PG-13
919,Hugo,185770310,73864507,0.39799999999999996,111905803,0.602,2011,PG
920,Pitch Perfect 3,185400345,104897530,0.5660000000000001,80502815,0.434,2017,PG-13
921,Watchmen,185382813,107509799,0.58,77873014,0.42,2009,R
922,The Birdcage,185260553,124060553,0.67,61200000,0.33,1996,R
923,Moulin Rouge!,184935320,57386607,0.31,127548713,0.69,2001,PG-13
924,Snow White and the Seven Dwarfs,184925486,184925486,1.0,0,,1937,Approved
925,Hop,184367145,108498305,0.588,75868840,0.41200000000000003,2011,PG
926,Bad Moms,183936074,113257297,0.616,70678777,0.384,2016,R
927,Jupiter Ascending,183887723,47387723,0.258,136500000,0.742,2015,PG-13
928,Knowing,183658498,79957634,0.435,103700864,0.565,2007,PG-13
929,102 Dalmatians,183611771,66957026,0.365,116654745,0.635,2000,
930,Storks,183510278,72800603,0.397,110709675,0.603,2016,PG
931,Stand by Me Doraemon,183442714,,,183442714,1.0,2014,
932,Paul Blart: Mall Cop,183348429,146336178,0.7979999999999999,37012251,0.20199999999999999,2009,PG
933,Wayne's World,183097323,121697323,0.665,61400000,0.335,1992,PG-13
934,Maverick,183031272,101631272,0.555,81400000,0.445,1994,PG
935,Mirror Mirror,183018522,64935167,0.355,118083355,0.645,2012,PG
936,The Man in the Iron Mask,182968902,56968902,0.311,126000000,0.6890000000000001,1998,PG-13
937,Cape Fear,182291969,79091969,0.434,103200000,0.5660000000000001,1991,R
938,The Haunted Mansion,182290266,75847266,0.41600000000000004,106443000,0.584,2003,PG
939,The Monkey King Havoc in Heavens Palace,182206924,,,182206924,1.0,2014,
940,While You Were Sleeping,182057016,81057016,0.445,101000000,0.555,1995,PG
941,The Bridges of Madison County,182016617,71516617,0.39299999999999996,110500000,0.607,1995,PG-13
942,From Vegas to Macau III,181732879,,,181732879,1.0,2016,
943,Poseidon,181674817,60674817,0.33399999999999996,121000000,0.6659999999999999,2006,PG-13
944,The First Wives Club,181489203,105489203,0.581,76000000,0.419,1996,PG
945,Cliff Walkers,181325565,152972,0.001,181172593,0.9990000000000001,2021,
946,Scooby-Doo 2: Monsters Unleashed,181239132,84239132,0.465,97000000,0.535,2004,PG
947,Hot Shots!,181096164,69467617,0.384,111628547,0.616,1991,
948,Road to Perdition,181001478,104454762,0.5770000000000001,76546716,0.423,2002,R
949,Kill Bill: Vol. 1,180906076,70099045,0.38799999999999996,110807031,0.612,2003,R
950,Abominable,180733970,61270390,0.33899999999999997,119463580,0.6609999999999999,2019,PG
951,The Scorpion King,180630907,91047077,0.504,89583830,0.496,2002,PG-13
952,Sweet Home Alabama,180622424,127223418,0.7040000000000001,53399006,0.29600000000000004,2002,PG-13
953,Daddy's Home 2,180613824,104029443,0.5760000000000001,76584381,0.424,2017,PG-13
954,Hacksaw Ridge,180563636,67209615,0.37200000000000005,113354021,0.628,2016,R
955,Deja Vu,180557550,64038616,0.355,116518934,0.645,2006,PG-13
956,The Post,180419276,81903458,0.45399999999999996,98515818,0.546,2017,PG-13
957,Dangerous Minds,179519401,84919401,0.473,94600000,0.527,1995,R
958,The Dictator,179379533,59650222,0.332,119729311,0.6679999999999999,2012,R
959,The League of Extraordinary Gentlemen,179265204,66465204,0.371,112800000,0.629,2003,PG-13
960,Allegiant,179246868,66184051,0.369,113062817,0.631,2016,PG-13
961,Daredevil,179179718,102543518,0.5720000000000001,76636200,0.428,2003,PG-13
962,City Slickers,179033791,124033791,0.693,55000000,0.307,1991,
963,He's Just Not That Into You,178866158,93953653,0.525,84912505,0.475,2009,PG-13
964,Eagle Eye,178767383,101440743,0.5670000000000001,77326640,0.433,2008,PG-13
965,Along Came Polly,178311729,88097164,0.494,90214565,0.506,2004,PG-13
966,Flushed Away,178281554,64665672,0.363,113615882,0.637,2006,PG
967,Scary Movie 4,178262620,90710620,0.509,87552000,0.491,2006,PG-13
968,Dante's Peak,178127760,67127760,0.377,111000000,0.623,1997,PG-13
969,Brokeback Mountain,178062759,83043761,0.466,95018998,0.534,2005,R
970,Patriot Games,178051587,83351587,0.46799999999999997,94700000,0.532,1992,R
971,Flubber,177977226,92977226,0.522,85000000,0.478,1997,PG
972,Baywatch,177856751,58060186,0.326,119796565,0.674,2017,R
973,Double Jeopardy,177841558,116741558,0.6559999999999999,61100000,0.344,1999,R
974,War Horse,177584879,79884879,0.45,97700000,0.55,2011,PG-13
975,Paranormal Activity 2,177512032,84752907,0.47700000000000004,92759125,0.523,2010,R
976,How to Lose a Guy in 10 Days,177502387,105813373,0.596,71689014,0.40399999999999997,2003,PG-13
977,Alien vs. Predator,177427090,80282231,0.452,97144859,0.5479999999999999,2004,PG-13
978,Hero,177395557,53710019,0.303,123685538,0.6970000000000001,2002,PG-13
979,The 40-Year-Old Virgin,177378645,109449237,0.617,67929408,0.38299999999999995,2005,R
980,Lee Daniels' The Butler,177313795,116632095,0.6579999999999999,60681700,0.342,2013,PG-13
981,The Haunting,177311151,91411151,0.516,85900000,0.484,1999,PG-13
982,The Descendants,177243185,82584160,0.466,94659025,0.534,2011,R
983,The A-Team,177238796,77222099,0.436,100016697,0.564,2010,PG-13
984,Tootsie,177200000,177200000,1.0,0,,1982,
985,In the Line of Fire,176997168,102314823,0.578,74682345,0.42200000000000004,1993,R
986,Analyze This,176885658,106885658,0.604,70000000,0.396,1999,R
987,The Hitman's Bodyguard,176600207,75468583,0.42700000000000005,101131624,0.573,2017,R
988,Looper,176506819,66486205,0.377,110020614,0.623,2012,R
989,Serial (Bad) Weddings,176404493,,,176404493,1.0,2014,
990,Ip Man 4: The Finale,176345966,3956031,0.022000000000000002,172389935,0.978,2019,
991,Dr. Dolittle 2,176104344,112952899,0.6409999999999999,63151445,0.359,2001,PG
992,The Italian Job,176070171,106128601,0.603,69941570,0.397,2003,PG-13
993,The Bucket List,175372502,93466502,0.5329999999999999,81906000,0.467,2007,PG-13
994,Sleeping with the Enemy,174999005,101599005,0.581,73400000,0.419,1991,R
995,Cowboys & Aliens,174822325,100240551,0.573,74581774,0.42700000000000005,2011,PG-13
996,The Mule,174804407,103804407,0.594,71000000,0.406,2018,R
997,George of the Jungle,174463257,105263257,0.603,69200000,0.397,1997,PG
998,Evan Almighty,174440724,100462298,0.5760000000000001,73978426,0.424,2007,PG
999,Amélie,174118254,33225499,0.191,140892755,0.809,2001,R
1000,Identity Thief,173965010,134506920,0.773,39458090,0.22699999999999998,2013,R
